1111111111111111111111111111111111
1E00000000000J0C00000C000000000001
1000010100100000101001000000010101
10100100101010100O1001000000010101
1P0000000C00C00L0000000000000000C1
1111111111111111111111111111111111