111111111111111111111
100000000000000000001
10000000000000000000111
100000000000000001111111
10000000000000000001
1000000000000000001111
1000000000000000111
1111111111111111111111111