111111111
1000000E1
10C00C001
100000001
101000101
100000001
100000001
10C00C001
100000001
101000101
100000001
100000001
10C00C001
100000001
100000001
10C00C001
100000001
100000001
101000101
1P0000001
111111111